Administrative United States Penitentiary, Thomson	Illinois
United States Penitentiary, Allenwood	Pennsylvania
United States Penitentiary, Atlanta	Georgia
United States Penitentiary, Atwater	California
United States Penitentiary, Big Sandy	Kentucky
United States Penitentiary, Beaumont	Texas
United States Penitentiary, Canaan	Pennsylvania
United States Penitentiary, Coleman I & II	Florida
United States Penitentiary, Florence ADX	Colorado
United States Penitentiary, Florence High	Colorado
United States Penitentiary, Hazeltonâ€ 	West Virginia
United States Penitentiary, Lee	Virginia
United States Penitentiary, Leavenworth	Kansas
United States Penitentiary, Lewisburg	Pennsylvania
United States Penitentiary, Lompoc	California
United States Penitentiary, Marion	Illinois
United States Penitentiary, McCreary	Kentucky
United States Penitentiary, Pollock	Louisiana
United States Penitentiary, Terre Haute	Indiana
United States Penitentiary, Tucson	Arizona
United States Penitentiary, Victorville	California
